26,40,40,40,40,40,40,40,40,26
26,40,40,40,40,40,60,60,40,26
26,40,40,40,40,1,1,1,1,26
26,40,40,40,40,40,40,40,40,26
26,40,60,40,40,40,40,40,40,26
26,1,1,40,40,40,40,40,40,26
26,40,40,40,40,40,60,40,40,26
26,40,40,40,40,1,1,1,40,26
26,60,40,40,60,40,40,60,40,26
26,1,1,1,1,1,1,1,1,26
